111111111111111111111111
1P0000000000000000000001
111111111111111111100001
100000000000000000001101
100111111111111111001101
100000000000000000001101
111111111111101100000001
100000000000001111111111
100111100111111110000001
100011000000000000110001
100011111111111111110001
1000011CC000000000000001
1000011CC0000000000000E1
111111111111111111111111